111111111111111111111
1P00000000000100000C1
10B000B0000B010000001
10BB00BBB0BB000G00001
10BC00000G000100000E1
111111111111111111111
