111111111111111111111
1CB000B00000100010001
1CB0B0B0B0B010101C101
1CB0B0B0B0B010101C101
1CC0B000BPB000100C0E1
111111111111111111111