111111111111111111111111111
1EGCC0000000C00B000000C0001
1CCCCB000000000BG0000000001
1CCCCB00000000GB000C00B00P1
101111111000000B000000B0001
1000000000G00000000000B0001
10000000000000000C000000001
111111111111111111111111111
