111111111111111111111111111
1EGCC0000000C00B000000000P1
1CCCCB000000G00BG0G0BBB0001
1CCCCB000000G0GB00GC00C0001
101111111000G00BB0GG0GGGGG1
10000000G0G0000000000B000G1
10G0G0001GGGGGGGGB0GGGGGGG1
111111111111111111111111111
